S MMMMMMMMMMMMM
  M   M    M  M
  M M M    M MM
  M M M    M MM
  M M      M  M
    M MMMMMM MM
M M M        MM
M MMMMMMMMMMMMM
M M           M
M M M   M     M
M M M   M     M
M M M   MMMMMMM
M M M         M
M   M         E
MMMMMMMMMMMMMMM
